/////://///////://///////://///
/000000000/000000000/000000000/
/000000000/000000000/000000000/
/000000000/000000000/000000000/
/000000000/000000000/000000000/
/000000000/000000000/000000000/
/000000000/000000000/000000000/
/000000000/000000000/000000000/
/000000000/000000000/000000000/
/000000000/000000000/000000000/
/////0///////////////////0/////
/000000000/000000000/000000000/
/000000000/000000000/000000000/
/000000000/000000000/000000000/
/000000000/000000000/000000000/
/000000000/0000000000000000000/
/000000000/000000000/000000000/
/000000000/000000000/000000000/
/000000000/000000000/000000000/
/000000000/000000000/000000000/
/////://///////://///////://///