0000000000000000000000000000000000000000000000000000000000000000000000000000000
////////////////////////////////////////////////////////////////////0//////////
//////////////////////////////////////////////////////////////////00000////////
//////////////////////////////////////////////////////////////////00000////////
//////////////////////////////////////////////////////////////////00000////////
//////////////////////////////////////////////////////////////////00000////////
//////////////////////////////////////////////////////////////////00000////////
////////////////////////////////////////////////////////////////////0//////////
:000000000000000000000000000000000000000000000000000000000000000000000000000000
///////////////////////////////////////////////////////////////////////////////