0000000///////////////
0000000/////////11:///
0000000/////////1/////
0000000//////11111111/
000000000000011111111/
0000000//////11111111/
0000000//////111111///
0000000////////22/////